E E E 0 0 0 1
0 0 0 0 0 0 0
A A C 0 0 0 D
0 0 C 0 0 0 D
F 0 G G G B 0
F 0 0 0 0 B 0
F 0 0 1 0 0 0