E E E 1 0 0 1
0 0 1 0 0 0 1
A A 0 0 0 0 D
1 0 C 0 0 1 D
F 0 C G G B 0
F 0 1 0 0 B 0
F 0 0 1 0 1 0
